6 6 0 0 0 0 4 3 6
7 0 1 0 3 3 0 0 7
6 6 5 0 0 3 0 1 3
6 3 0 3 0 3 0 3 6
6 6 0 0 0 0 0 0 0
6 0 3 1 3 4 3 2 4
6 0 0 0 0 0 0 0 0
4 2 3 4 3 1 3 0 3
6 0 0 0 0 0 0 0 6
6 3 0 3 0 3 0 3 6
6 3 1 0 3 0 0 0 3
7 0 0 3 3 0 1 5 7
6 6 3 0 4 0 0 0 6