4 4 0 0 0 0 3 2 4
5 0 1 0 2 2 0 0 5
4 4 3 0 0 2 0 1 2
4 2 0 2 0 2 0 2 4
4 4 0 0 0 0 0 0 0
4 0 2 1 2 3 2 1 3
4 0 0 0 0 0 0 0 0
3 1 2 3 2 1 2 0 2
4 0 0 0 0 0 0 0 4
4 2 0 2 0 2 0 2 4
4 2 1 0 2 0 0 0 2
5 0 0 2 2 0 1 3 5
4 4 2 0 3 0 0 0 4